Genes: 803,39,32,390,499,272,1071,405,390,616,87,1411,39,1128
4,2,5,4,1,1,0,1,2,6,7,3,0,7
Fitness: 83.75
Constraints: 1.0
Age: 5
Level:
--------------------------------------------------------------------------S--S------------------------------------------------------------------------------------------------------------------SS----------------------------------------------------------
--------------------------------------------------------------------------S--S---X--------------------------------------------------------------------------------------------------------------------------------------------------------------------------
--------------------------------------------------------------------------S--S---X------------------------------------------------------------------------------------------------------------------------------------------------------------------k-------
--------------------------------------------------------------------------S--S-S-X----------------------------------------------------------------------------------------------------------------------------------------------------------@-------#-------
---------------------------------------------------------------------------------X-------------------------------------------------------------------------------------------------------------------------------------------------------------S----#-------
---------------------------------------------------------------------------------X------------------------------------------------------S----------------------------------------------------------------------------------k------------------------#-------
-----------------------------------------------------------S--------------g------X-----------------------------------------------------------------------------------------------------------------------------------------Q------------------?1----#-------
--------------------------------------------------------------------------S--S--UX-----------------------------------------------C-------------------------------------------------------C------U-------------------------------------------!-------#-------
--------------------------------------K---U-------------------------------S--S---X--------------------------------------##--------------------------------------------------------------------------------------------------------------------------#-------
--------------------------------------------------------------------------S--S---X-----------C--Q-----------------------##-------S---#---------------------------------------------------S-------t-------------------------------------------S------#-------
-----------------------!--------------------k---S%------------------------S--S---X-------------------------------------!##---------k-#-----------------------------------------------------k-k---t-------------------------Q------------------S-----#-------
------U-----------------------------XXXXX-%XXX----XX--------------------XXXXXXXXXXX---XX-----S--------------------------##----XXX-XXXXX----XXX---------------------------------K----XXXXX-XXXXXXXXXX-------#------------------------------XXX--XXXXXXXXXXX--
--#-----------------S---------------XXXXX--XXX----XX--------------------XXXXXXXXXXX---XX------k#-g----------------------##----XXX-XXXXX----XXX--------------------------------------XXXXX-XXXXXXXXXX------k#ky----------------------------XXX--XXXXXXXXXXX--
--#-----kk--S---------k-------------XXXXXXXXXXXXXXXX--------g#----------XXXXXXXXXXXXXXXX--XXX-XXXXXXX---XX--------------##----XXXXXXXXXXXXXXXX--------#y----------------------------XXXXXXXXXXXXXXXX--XXXXXXXXXXXXXXXX------k-------------XXXXXXXXXXXXXXXX--
XXXXXX%XXXX---XXXXXX-XXXXXXXXXXXXXXXXXXXXXXXXXXXXXXXXXXX%--XXXXX----XXXXXXXXXXXXXXXXXXXXXXXXX-XXXXXXX---XXXXXXXXXXXXXXXXXXXXXXXXXXXXXXXXXXXXXXXXXX----XXX-----XXXXXX------XXXXXXXXXXXXXXXXXXXXXXXXXXXXXXXXXXXXXXXXXXXXXXXX-XXXXXXXXXXXXXXXXXXXXXXXXXXXXXXXXX
XXXXXX-XXXX---XXXXXX-XXXXXXXXXXXXXXXXXXXXXXXXXXXXXXXXXXX---XXXXX----XXXXXXXXXXXXXXXXXXXXXXXXXXXXXXXXXXXXXXXXXXXXXXXXXXXXXXXXXXXXXXXXXXXXXXXXXXXXXX----XXX-----XXXXXX------XXXXXXXXXXXXXXXXXXXXXXXXXXXXXXXXXXXXXXXXXXXXXXXX-XXXXXXXXXXXXXXXXXXXXXXXXXXXXXXXXX


