Genes: 839,5,594,374,1253,386,904,855,1251,374,1516,374,1112,667
0,4,0,1,5,4,3,1,0,5,3,3,4,2
Fitness: 41.25
Constraints: 1.0
Age: 17
Level:
------------------------------------------------------------------------------------------------------------------------------------------------------------------------------------------------------------------------------------------------------------
-------------------------------------------------------------------------------------------------------------------------------------------X-----------------------------S----------------------------------------------------------------------------------
-------------------------------------------------------------------------------------------------------------------------------------------X----------------------------------------------------------------------------------------------------------------
-------------------------------------------------------------------------------------------------S---------------------------------------Q-X---------S-------------------------------------------------------------------------S-S--------------------------
-------------------------------------------------------------------------------------------------------------------------------------------X---------S---X-----------------------------------------------------------------------S--------------------------
-------------------------------------------------------------------------------------------------------------------------------------------X---------C---X-----------------------------------------------------------------------S--------------------------
-------------------------------------------------------------------------------------------------------------------------------------------X---------S--QX------------------------------------------------------------------Q----S--------------------------
---------------------------------------------------------------S-------------------------------------------------------------------------?-X-------------X----------------------------------------------------------------------T---------------------------
--------------------------------------------------------------------------------------------------------------!----------------------------X-------------X------------------------------Q---------------------------------------T---------------------------
------------------------------------------o---------------------------------------------------------------------------------------------#--X---------g---X----------------------------------------------------------------------T---------------------------
-----------------------------------------------------------------------------------------------------------------------------------k-g--#--X-------C-SQ-?X-------------------------------#----------------------------------?---XS----------!S--------------
----------------------------------------------------------------g-------------------------------U-------------k-k-------------XXXXXXXXXXXXXXXX-------S---X---------------#-----g---------#---------------------------------------S--------------------------
--------------------------------------#---------------XXXXXXXXXXX---XX--------------------------------------XXXXXXXXXX----XX--XXXXXXXXXXXXXXXX-----S-S---X--------XX%--XXXXXXXXXXX--XXXXXXXXXXXXXXXX------k-#-------------#------S--------------------------
--------------------o-----------------#---------------XXXXXXXXXXX---XX--XX----XXXXXXXXXX----o----#g----k----XXXXXXXXXX----XX--XXXXXXXXXXXXXXXX------kS--gX--------XX---XXXXXXXXXXX--XXXXXXXXXXXXXXXX--XXXXXXX-------XX----#kg--#kS----------k-k-------------
XXXXXX--------XXXXXX%XXXXXXXXXXXXXXXXXXXX-----XXXXXXXXXXXXXXXXXXXXXXXXXXXX----XXXXXXXXXXXXXX%X-X%XXXXXXXXXXXXXXXXXXXXXXXXXXXXXXXXXXXXXXXXXXXXXXXXXX-XXXXXXX-XXXXXXXXXXXXXXXXXXXXXXXXXXXXXXXXXXXXXXXXXXXXXXXXX-------XXXXXXXXXXXXXXX---XXXXXXXXXXXXXXXXXXXXXX
XXXXXX--------XXXXXX-XXXXXXXXXXXXXXXXXXXX-----XXXXXXXXXXXXXXXXXXXXXXXXXXXXXXXXXXXXXXXXXXXXXX-X-X-XXXXXXXXXXXXXXXXXXXXXXXXXXXXXXXXXXXXXXXXXXXXXXXXXX-XXXXXXX-XXXXXXXXXXXXXXXXXXXXXXXXXXXXXXXXXXXXXXXXXXXXXXXXXXXXXXXXXXXXXXXXXXXXXXX---XXXXXXXXXXXXXXXXXXXXXX


