Genes: 1,142,453,315,449,302,424,34,142,33,423,34,397,430
1,0,0,0,1,1,1,1,1,0,0,0,1,0
Fitness: 76.25
Constraints: 1.0
Age: 53
Level:
------------------------------------------------------------------------------------------------------------------------------------------------------------------------------------------------------------------------------------------------------------
--------------------------------------------------------------------------------------------------------------S---------------------------------------------------------------------------------------------------------------------------------------------
---------------------------------------------------------------------------------------------------X----------S----------------------------------------------------------------------------------------------------------------S----------------------------
---------------------------------------------------------S-----------------------------------------X----------S---------------------------------------------------------------------------------------------------------------------------------------------
---------------------------------------------------------S---------X------------------------------QX---o------S-R----------------------------------------------------------X--------------------------------------------------------------------------------
---------------------------------------------------------S---------X-------------------------------X-----------------------------------------------------------------------X--------------------------------------------------------------------------------
--------------------------------------------------------S--------Q-X-------------------------------X---------------------------------------------------------------------S-X----------S---------------------------------------------------------------------
-------------------------------------------------------------------X-------------------------------X----------o------------------------------------------------------------X-------------------------------------------------o----S-------------------------
----------------------------------------------S--------------------X----------------------------S-?X----------S-----Q------------------------------------S-----------------X--------------------------------------------------------------------------------
--------U------------------S------------o--------------------------X---------SQ-------------X------X-----------------------------------------------------------------------X-----------------------------------------------C--Q-----------------------------
---------------------------------------C-----------------S-------?-X---------K--------------X------X-----------T------------------------------------------------------SSQ-UX----------SQ-----------------------------------------------------C--------------
---------------------------------------------------------S---------X------------------------X-----gX----------kTo----g--------XX-----XXXXXXXXX-------------------------K---X----------K------------------------------------S-S------------------------------
----------k----------------------------S---t------------SS------#--X-----------g----kg----XXXXXX-XXXXX--XX--XXXX%XXXXXXXXXXX--XX-----XXXXXXXXX------------g----------------X------------------------------------------------k---y------------S--------------
XXXXXXXXXXXXXXXX------------g-----------kk-t---------------k-g--#--X----XXXXXXXXXXXXXXXX--XXXXXX-XXXXX--XX--XXXX|XXXXXXXXXXX--XXXXXXXXXXXXXXXX--XXXXXXXXXXX---XX-----------X--------------------------------------------XXX-X-XXX-----XX------kk------------
XXXXXXXXXXXXXXXXXXXXXXXXXXXXX---XXXXXXX-XXXX-----XXXXXXX-XXXXXXXXXXXXXXXXXXXXXXXXXXXXXXXXXXXXXXXXXXXXXXXXXXXXXXXXXXXXXXXXXXXXXXXXXXXXXXXXXXXXXXXXXXXXXXXXXX---XXXXXXXXXXXXXXXXXXXXXXXXXXXXXXXXXXXXXXXXXX-----XXXXXXXXXXXXXX-X-XXX-----XXXXXX--XX----XXXXXXXX
XXXXXXXXXXXXXXXXXXXXXXXXXXXXX---XXXXXXX-XXXX-----XXXXXXX-XXXXXXXXXXXXXXXXXXXXXXXXXXXXXXXXXXXXXXXXXXXXXXXXXXXXXXXXXXXXXXXXXXXXXXXXXXXXXXXXXXXXXXXXXXXXXXXXXXXXXXXXXXXXXXXXXXXXXXXXXXXXXXXXXXXXXXXXXXXXXXX-----XXXXXXXXXXXXXXXXXXXXXXXXXXXXXXX--XX----XXXXXXXX


