Genes: 4,478,330,1001,404,478,122,478,122,478,1323,1458,122,1001
1,3,3,2,1,3,2,0,3,3,0,1,1,2
Fitness: 66.25
Constraints: 1.0
Age: 1
Level:
--------------------------------------------------------------------------------------------------------------------------------------------------------------------------------------------------------------------------------
--------------------------------------------------------------------------------------------------------------------------------------------------------------------------------------------------------------------------------
--------------------------------------------------------------------------------------------------------------------------------------------------------------------------------------------------------------------------------
--------------------------------------------------------------------------------------------------------------------------------------------------------------------------------------------------------------------------------
--------------------------------------------------------------------------------------------------------------------------------------------------------------------------------------------------------------------------------
--------------------------------------------------------------------------------------------------------------------------------------------------------------------------------------------------------------------------------
--------------------------------------------------------------------------------------------------------------------------------------------------------------------------------------------------------------------------------
------------------------S---------------------------------------------------------------S---------------------------------------------------------------S-----------------------------------------------------------------------
--------------------------------------------------------------------------------------------------------------------------------------------------------------------------------------------------------------------------------
----------------------Q---------------------------------------------------------------Q----------------------------------S----------------------------Q-------------------------------------------------------------------------
---L-------------------------------------------------------------------T----------------------------------------------------------------------------------------------------------!---------------------------------------------
-----------------------------------------------------------------------T--------------------------------------------------------------------------------------------------------------------------------------------------------
----------------------------------S------------------------------------T--------------------------------------------------------------------------------------------------------------------------------------------------------
----k-----------------S---------------------------------k---------k----T--------------S-----------------------------------g---------------------------S---------------------------k-k-----------------------------------k-------
XXXXXXXXXXXXXXXXXX-------XXXXXXXXX---XXXXXXXXXXXXXXXXXXXXX----XXXXXXXXXXXX----XXXX-------XXXXXXXXX----XXXXXXXXXXXXXXXXXXXXX---XXXX-----XXXXXXXXXXX-------XXXXXXXXXXXXXXXXXXXXXXXXXXXXXXXXX----XXXX-----XX-----XXXXXXXXXXXX----XX
XXXXXXXXXXXXXXXXXX-------XXXXXXXXX---XXXXXXXXXXXXXXXXXXXXX----XXXXXXXXXXXX----XXXX-------XXXXXXXXX----XXXXXXXXXXXXXXXXXXXXX---XXXX-----XXXXXXXXXXX-------XXXXXXXXXXXXXXXXXXXXXXXXXXXXXXXXX----XXXX-----XX-----XXXXXXXXXXXX----XX


