Genes: 4,478,330,1001,404,404,478,122,1251,122,478,1458,398,89
3,3,1,0,1,3,1,1,0,1,2,1,0,1
Fitness: 88.75
Constraints: 1.0
Age: 58
Level:
------------------------------------------------------------------------------------------------------------------------------------------------------------------------------------------------------------------------------------------------------------
------------------------------------------------------------------------------------------------------------------------------------------------------------------------------------------------------------------------------------------------------------
------------------------------------------------------------------------------------------------------------------------------------------------------------------------------------------------------------------------------------------------------------
-------------------------------------------------------------------------------------------------------------------------------------------------------------------------------------------S-------------------------------S--------------------------------
---------------------------------------------------------------------------------------------------------------------------------------------------------------------------------------------------------------------------S---------X----------------------
---------------------------------------------------------------------------------------------------------------------------------------------------------------------------------------------------------------------------S---------X----------------------
-----------------------------------------------------------------------------------------------------------------------------------------------------------------------------------------------------------------------------------Q-X----------------------
--------------------------S----------------------------------------------------------------------------------------------------------------------------------------------------------------------------------------------------------X----------------------
----------------------------------------------------------------------------------------------------------------------------------------------------------S--------------------------------------------------------------------------X----------------------
------------------------Q--------------------------------------------------------------------1------------------------------------------------------------------------------------------------------------------------------o--------X----------------------
----U--------------------------------------------------------------------------T------------------T------------------------------------------------C----------------------------------------------------!------------------S-------?-X---------@------------
-------------------------------------------------------------------------------T------------------T------------------------------------------------------------------------------------------------------------------------S---------X----------------------
--------------------------------------T----------------------------------------T------------#-----T------------------------------------------------S---#-------------------------------------------------------------------S-#----#--X------S---------------
-----kk------g----------S-------------T-----------------------------------k----T------------#-----T-------------k-#----------------------------------k-#-----------------------------------#-----g------k-k-----------------k#----#--X--------k-S-----------
XXXXXXXXXXXXXXXXXXXX-------XXXXXXXXXXXXXXXXXXXXXXXXXXXXXXXXX--------XXXXXXXXXXXXXX----XXXXXXXXXXXXXXXXXXXXXXXXXXXXX-------XXXXXX-----XX-----XXXXXXX-XXXXX----XXXXXXX-----XX-----XXXXXX%--XXXXXXXXXXXXXXXXXXXXXXX----XXXXXXXXXXXXXXXXXXXXXXXX-XXX-XX-----XXXX
XXXXXXXXXXXXXXXXXXXX-------XXXXXXXXXXXXXXXXXXXXXXXXXXXXXXXXX--------XXXXXXXXXXXXXX----XXXXXXXXXXXXXXXXXXXXXXXXXXXXX-------XXXXXX-----XX-----XXXXXXX-XXXXX----XXXXXXX-----XX-----XXXXXX---XXXXXXXXXXXXXXXXXXXXXXX----XXXXXXXXXXXXXXXXXXXXXXXX-XXX-XX-----XXXX


