1257,374,1504,839,1071,374,1253,374,1253,839,0,1337,0,839
6,7,5,1,3,4,1,2,6,4,6,3,4,2
------------------------------------------------------------------------------------------------------------------------------------------------------------------------------------------------------------------------------------------------------------
------------------------------------------------------------------------------------------------------------------------------------------------------------------------------------------------------------------------------------------------------------
------------------------------------------------------------------------------------------------------------------------------------------------------------------------------------------------------------------------------------------------------------
-------------------------------------------------------------------------------------------------S----------------------------------------------------------------------------------------------------------------------------------------------------------
------------------------------------------------------------------------------------------------------------------------------------------------------------------------------------------------------------------------------------------------------------
--------------------------S---------------------------------------------------------------------------------------------------------------------------------------------------------------------------------------------------------------------------------
------------------------------------------------------------------------------------------------------------------------------------------------------------------------------------------------------------------------------------------------------------
------------------------Q------------------------------------------------------T----------------------------------------------------------------------------------------------------------------------------------------------------------------------------
-------------------------------------------------------------------------------T------------------------------------------------------------------------------------------------------------------------!---------------------------------------------------
--------------------------------------#----------------------------------------T----------------------------------------------------------------------------------------------------------------------------------------------------------------------------
----U---------------------------------#-----------------------------------k----T----------------------------------------------------------------------------------------------------------------------------------------------------------------------------
------------------------S-----------XXXXXXXXXXXXXXXX--------------------XXXXXXXXXX----XX--------------------XX-----XXXXXXXXX----------------------------------------------------------------------------k--g------------------------------------------------
------------------XX-------XXXXXXX--XXXXXXXXXXXXXXXX--XXXXXX--------XX--XXXXXXXXXX----XX--------------------XX-----XXXXXXXXX--------------------------------------------------------------------------XXXXXXXXXXXXXXXX--------------------------------------
-----kk------g----XX-------XXXXXXX--XXXXXXXXXXXXXXXX--XXXXXX--------XX--XXXXXXXXXXXXXXXX---------#-----g----XXXXXXXXXXXXXXXX------k-#-------------------------------------k---------------------------XXXXXXXXXXXXXXXX--------------------------------------
XXXXXXXXXXXXXXXXXXXXXXXXXXXXXXXXXXXXXXXXXXXXXXXXXXXXXXXXXXXXXXXXXXXXXXXXXXXXXXXXXXXXXXXXXXXX%--XXXXXXXXXXXXXXXXXXXXXXXXXXXXXXXXXXXXXX-------XXXXXX-----XXXXXXXXXXXXXXXXXXXXX----XXXXXXXXXXXXXXXXXXXXXXXXXXXXXXXXXXXXXXXXXXXXXXXXXXXXXXXXXXXXXXXXX-------XXXX
XXXXXXXXXXXXXXXXXXXXXXXXXXXXXXXXXXXXXXXXXXXXXXXXXXXXXXXXXXXXXXXXXXXXXXXXXXXXXXXXXXXXXXXXXXXX---XXXXXXXXXXXXXXXXXXXXXXXXXXXXXXXXXXXXXX-------XXXXXX-----XXXXXXXXXXXXXXXXXXXXX----XXXXXXXXXXXXXXXXXXXXXXXXXXXXXXXXXXXXXXXXXXXXXXXXXXXXXXXXXXXXXXXXX-------XXXX


