Genes: 1285,914,31,637,1030,345,254,229,1403,267,371,1368,410,77
3,2,3,0,3,0,0,1,1,2,2,0,0,3
Fitness: -35.0
Constraints: 1.0
Age: 1
Level:
--------------------------------------------------------------------------------------------------------------------------------------------------------------------------------------------------------------------------------
--------------------------------------------------------------------------------------------------------------------------------------------------------------------------------------------------------------------------------
--------------------------------------------------------------------------------------------------------------------------------------------------------------------------------------------------------------------------------
-----------S----------S--------------------------------------------------S--------S----------------S------------------------------S---S----------------------------------------------------S------------------------------------
-----------S----------------------------------------------------------------------S----------------S-----X------------------------S---S----------------------X-----------------------------S------------------------------------
-----------S----------------------------------------------------------------------S----------------S-----X------------------------S---S----------------------X-----------------------------S------------------------------------
-----------S--------------------------------------S-------------------------------S---------------------QX------------------------S---S-------------------U--X-----------------------------S------------------------------------
-----------S---------------------------------------------------------------------------------------------X----------------------------S----------------------X-----------------------------S------------------------------------
-----------S---------------------------------------------------------------------------------------------X----------------------------S----------------------X-----------------------------S------------------------------------
-----------S--------------------------------------------------------?-------------o---------------S-o----X----------------------------S----------------------X-----------------------------S--------o---------------------------
-----------S----------------------------o---------SQ------------------------Q-----S----------------S----?X----------------C-------SL--S--------------------U-X---------Q----------------U--S-------C--L-------------------------
------K----S--------------------------------------K------------------------------------------------S--Sy-X------------------------S---S----------------------X------------------------------------------------------------------
--#--------S-------o--g--------------------------------------------S---------t-----t---------------S-#-#-X------------------------S---S-------------------#--X----S-------------------------K------S----------------------------
--#-------kS------o%--#-k---S-------------k---------kk------------g-S-%-k----t----ktyk--------------k#-#gX------------------kk----S-k-S-----------o------g#--X----------k-----------------k---------k#-------k----------r-------
XXXXXXXXXXXXXXXXXX%|XXXXXX----XXXX-----XXXXXXXXXXXXXXX----XXXXXXXXX---|XXXXXXXXXXXXXXXXXXXXXXXXXXXXXXX-XXXXXXXXXXXXX--XXXXXXXXXXXXXXXXXXXXXXXXXXXX%-XXXXXXXXXXXXXX--XXXXXXXXXXXXXX-XXXXXXXXXXXXXXXX-XXXXX-XXXXXXXX-----XXXXXXXXX
XXXXXXXXXXXXXXXXXX-|XXXXXX----XXXX-----XXXXXXXXXXXXXXX----XXXXXXXXX---|XXXXXXXXXXXXXXXXXXXXXXXXXXXXXXX-XXXXXXXXXXXXX--XXXXXXXXXXXXXXXXXXXXXXXXXXXX--XXXXXXXXXXXXXX--XXXXXXXXXXXXXX-XXXXXXXXXXXXXXXX-XXXXX-XXXXXXXX-----XXXXXXXXX


