Genes: 682,803,801,829,466,444,263,371,930,1194,766,1358,801,341
0,0,1,3,0,0,0,2,2,1,2,3,0,0
Fitness: 100.0
Constraints: 1.0
Age: 2
Level:
--------------------------------------------------------------------------------------------------------------------------------------------------------------------------------------------------------------------------------
--------------------------------------------------------------------------------------------------------------------------------------------------------------------------------------------------------------------------------
--------------------------------------------------------------------------------------------------------------------------------------------------------------------------------------------------------------------------------
---S---------------S-----------------------------------------------------------------S----S-------S--------------------------------------S--------------------------------------------------------S-----S-----------------------
---S---------------S-------------------------X----------------------------------------------------S------------------------------------------X---------------------------------------------------------------X------------------
---S---------------S-------------------------X----------------------------------------------------S------------------------------------------X---------------------------------------------------------------X------------------
--S---------------------------------------U--X----------------------------------------------------S---------------------------------------U--X---------------------------------------------------------Q---S-X------------------
---------------------------------------------X------------------------------------------------------------------------------------------T----X---------------------------------------------------------------X------------------
---------------------------------------------X------------------------------------------------------------------------------------------T----X---------------------------------------------------------------X------------S-----
------------------k-o------------------------X----------------------------------------------------g-------------------------------------T----X-------S-----------------------------S-------------------------X------------------
--SS----U---------SS--Q----S---------------U-X-------------2-------C--Q----S-------C----U---------S--------------------Q----------------X--U-X---------S----------%@-----------------------------------?-----X-----C--Q---------
--KS---------------S-------------------------X---------------------------------------S------------S------------------------------------------X-----------K----------------------------------------##---------X---------y--------
---S---------------S--------#-------------#--X-----S---------------S---------------S-S------------S---------------S-----------------------#--X---------K------------------------------------------##---------X-----S---#--------
--------------------k#------#------------k#--X-------k----k---------kk--------------kS-------k----S---------------------k---------------k-#--X--------#------------g----k-----------K----k--------##---g---k-X------k#-#--------
XXXXXXXXXXXXXXXXXXXXXXXXXXXXXXXXXXX---XXXXXXXXXXXXX-XXXXXXXX-XXXXXX-XXXXXX----XXXXX-XXXXX--XXXXXXXXXXXXXXXXXXXXXXX--XXXXXXXXXXXXXX-XXXXXXXXXXXXXXXXXXXXXXXXXXXXXXX-XXXXXXXXXXXXXXX--XXXXXXXXXXXXXXXXX-XX-XXXXXXXXXX-XXXXX-----XX
XXXXXXXXXXXXXXXXXXXXXXXXXXXXXXXXXXX---XXXXXXXXXXXXX-XXXXXXXX-XXXXXX-XXXXXX----XXXXX-XXXXX--XXXXXXXXXXXXXXXXXXXXXXX--XXXXXXXXXXXXXX-XXXXXXXXXXXXXXXXXXXXXXXXXXXXXXX-XXXXXXXXXXXXXXX--XXXXXXXXXXXXXXXXX-XX-XXXXXXXXXX-XXXXX-----XX


