Genes: 1598,957,1443,419,1074,772,516,839,748,104,1103,839,1618,367
1,0,1,2,1,2,1,3,0,0,2,1,2,2
Fitness: 88.75
Constraints: 1.0
Age: 4
Level:
--------------------------------------------------------------------------------------------------------------------------------------------------------------------------------------------------------------------------------
--------------------------------------------------------------------------------------------------------------------------------------------------------------------------------------------------------------------------------
--------------------------------------------------------------------------------------------------------------------------------------------------------------------------------------------------------------------------------
-----------------------------------------S-----------S-S-S----------------------------------------------------------------------------------------------------------------------------------------------------------------------
-------------------------X-------------------X-----------S----------------------------------------------------------------------------------------------------------------------------------------------------------------------
-----------k-------------X-------------------X-----------Sk---------------------------------------------------------------------------------------------------------------------------------------------------------------------
-----------S------------QX----------------U--X--------S---#--------------------------------------------Q------------y-----------------------------------------------------------------------------------------------R--------@--
-------------------------X-------------------X------------#R--------------------------------------------------------S----------------------------------------------------------------------------------------------#------------
-------------------------X-------------------X------------#--------------------------------------------------------------------------------------------------------------------------------------------------------#------------
-------------------------X-------------------X-----------o#-----------------------------------------------------------Q------------------o-------------------------------------------------------------------------#------------
----------L-----------S-?X-----------------U-X-------@S--S#---------------Q----------------------------?--Q----------------------------------------C-----------------------S----------!--------------------S-------#---------!--
------------------X------X-------------------X----T-------#---------------------------U------------------------------------------------------#--------------------#-------------------------------#----------------#------------
------------------X------X----------------#--X----T-------#-----------------------#--------------------------------S-------------------------#-----S--------------#---------------S---------------#----------------#------------
------------------X-----gX----------------#--X----T---gk--#-k---------k-----k-----#----kk-------------#gk---k--------kS-------------------g--#------kk--------------k--g------------k-k--S----------k--g----S-----##o---g-------
XXXXXXXXXXXXXXXXXXXXXX-XXXX--%XXXXXXXXXXXXXXXXXXXXX-XXXXXXX-XXXXXX----XXXXXXXXXXXXXXXX%XXXXXXXXXXXXXXXXXXXXXXXXXXXX-XX--XXXXXXXXXXXXXX----XXXXXXXXX-XXXXXXX---XXXXXXXXXXXXXXX-XXXX-XXXXXX-----XXXXXXXXXXXXXX--XXXXXX%XXXXXX--XXX
XXXXXXXXXXXXXXXXXXXXXX-XXXX---XXXXXXXXXXXXXXXXXXXXX-XXXXXXX-XXXXXX----XXXXXXXXXXXXXXXX-XXXXXXXXXXXXXXXXXXXXXXXXXXXX-XX--XXXXXXXXXXXXXX----XXXXXXXXX-XXXXXXX---XXXXXXXXXXXXXXX-XXXX-XXXXXX-----XXXXXXXXXXXXXX--XXXXXX|XXXXXX--XXX


