Genes: 373,276,214,352,337,369,184,407,320,368,429,75,334,485
1,1,0,1,0,0,1,0,0,1,1,0,0,1
Fitness: 92.5
Constraints: 1.0
Age: 46
Level:
---------------------------------------------------------------S--------------------------------------------------------------------------------------------------------------------------------------------------------------------------------------------
--SS---------------------------------------------------------------X----------------------------------------------------------------------------------------------------S-----------------------------------------------------------------------------------
--SS---------------------------------------------------------------X-------------------------------------------------------------------------------------------------------X--------------------------------------------------------------------------------
--SS------------------------------------------------------------U--X------------------------SS---------------------------------------S------------SS-----------------------X-----------------------------S----------------S---------------------------------
-------------------------------------------------------------------X-----------------X-------S---------X-------------------------------------------S----------------------SX-----------------------------S-----X----------S---------------------------------
-------------------------------------------------------------------X-----------------X-------S---------X------S------------------------------------S-----------------------X-----------------------------S-----X----------S---------------------------------
----------------------------S---------S----------------------------X--------------U--X---------------Q-X-------------------------------------------------------------------X----------------------------------QX----------S---------------------------------
-----------------------------o-----------------------------------U-X-------------S---X-----------------X--------------------------------------------------------------o----X-----------------------------------X--------------------------------------------
---S--------------------L------------------------------------------X-----------------X-----------------X-------------------------------------------------------------C--S--X--------------L--------------------X-----------------------------C--------------
---S------------------------------------------------------------#--X-----------------X-----------------X------SQ-----------------------------------------?-----------------X----------------------------S-o----X----------g---------------------------------
---S-----------------#---#------------SC------------------------#--X---------------U-X-------S-------?-X------K------------------C--L--------------S--L--------------S-----X-----------#-----------------S----?X----------S-----U------------S--------------
----k#-g------------##-k-#g-----------K---K-----------XX%--XXXXXXXXXXX----#----------X-------S---------X--------------------------------S----------S------------------kk---X----------##k----------------S--Sy-X----------S-------------------k#-------k----
XXXXXXXXXX----XX--XXXXXXXXX-----XX-----S--------------XX---XXXXXXXXXXX----#-------#--X-------S------#--X--------kk---------------S-----------------S--------------XXX-XXXXXXXXXXXX--XXXXXXXXXXX---XX-----S-#-#-X----------S---------------XXX-XX-------XXX--
XXXXXXXXXX----XX--XXXXXXXXX-----XX--------------------XXXXXXXXXXXXXXXX------k-k---#-kX---------k----#--X----XXXXXX----XXXXXX------kk----------------gk---Sk-------XXX-XXXXXXXXXXXX--XXXXXXXXXXX---XX------k#-#gX----------S------g--------XXX-XX-------XXX--
XXXXXXXXXXXXXXXXXXXXXXXXXXXXXXXXXXXXXXX-XXXXXXXXXXXXXXXXXXXXXXXXXXXXXXXXXXXXXXXXX-XXXXXXXXXXXXXXXXXXXXXXXXXXXXXXXX----XXXXXXXXXXX-XXXXXX-XXXXXXXXXXXXXXXX-XXXXXXXXXXXXXXXXXXXXXXXXXXXXXXXXXXXXXXXXXXXXXXXXXX-XXXXXXXXXXXXXXXXXXXXXXXXXXXXXXXXXXXXXXXXXXXXXXX
XXXXXXXXXXXXXXXXXXXXXXXXXXXXXXXXXXXXXXX-XXXXXXXXXXXXXXXXXXXXXXXXXXXXXXXXXXXXXXXXX-XXXXXXXXXXXXXXXXXXXXXXXXXXXXXXXXXXXXXXXXXXXXXXX-XXXXXX-XXXXXXXXXXXXXXXX-XXXXXXXXXXXXXXXXXXXXXXXXXXXXXXXXXXXXXXXXXXXXXXXXXX-XXXXXXXXXXXXXXXXXXXXXXXXXXXXXXXXXXXXXXXXXXXXXXX


