Genes: 4,803,671,1034,330,1545,1030,212,304,961,200,1561,1057,1682
1,3,2,1,0,2,2,2,3,1,2,3,0,1
Fitness: 93.75
Constraints: 1.0
Age: 2
Level:
--------------------------------------------------------------------------------------------------------------------------------------------------------------------------------------------------------------------------------
--------------------------------------------------------------------------------------------------------------------------------------------------------------------------------------------------------------------------------
--------------------------------------------------------------------------------------------------------------------------------------------------------------------------------------------------------------------------------
------------------------------------------------------S------------------------------------------------------------------S-----------------------------------------------------------------SSS-----------S----------S------S----
---------------------------------------------X--------S------------------------------------------------------------------S-----------------------------------------------------------------S-----------------X---------------X--
---------------------------------------------X--------S------------------------------------------------------------------S-----------------------------------------------------------------S-----------------X--------------oX--
----------------------S--------------------S-X--------S------S------------------------------------------------------Q----S-------------------------Q---------------------------------------S--------------U--X------S-------%X--
---------------------------------------------X--------S-----------------------------------------------------------------T------------------------------------------------------------------S-----------------X------S-------|X--
---------------------------------------------X--------S-----------------------------------------------------------------T-----------------------------------------o------------------------S-----------------X------S-------|X--
---------------------------------------------X--------S-----------------------------------------------------------------T------------------------------------------------------------------S-----------------X-----1S-------|X--
---L---------------2--S-------------U---Q----X----S---S------S------------------------------------------------------?--SXS--------------Q----------Q--------------S------------------------SU--------------U-X------S-------%X--
-------------------------------------------K-X--------S-----------------------------------------------U------------------S--------------------------------------------U--------------------S-----------------X--------------|X--
------------------#------------------#-------X--------S-----------#------------------------------------------------------S-----------------------------------------S---------------S-------S-t----#-------#--X----#--T------|X--
----k-------------#-K-K---S-------o--#-------X------kgS---g-------#-----------------k-------------o--k--k---S%------g---kS----------------k---------k-#-----------------kk--S-----o--gk--k-S-t----#-k-k---#-kX----#--T--g---|X--
XXXXXXXXXXXXXXXXXXXXXXXXX--XXXXXXX%XXXXXXXXXXXXXXX-XXXXXXXXXXXXXXXXXXXXXXXXXXXXXXX-XXXXXXX----XXXX%XXX%XXXX---XXXXX-XXXXXXXXXXXXXXXXXXXXXXXXXXXXXX-XXXX-------XXXX--XX%XXXXX--XXXX%-XXXXXXXXXXXXXXXXXXXXX-XXXXXXXXXXXX--XXXX|XXX
XXXXXXXXXXXXXXXXXXXXXXXXX--XXXXXXX-XXXXXXXXXXXXXXX-XXXXXXXXXXXXXXXXXXXXXXXXXXXXXXX-XXXXXXX----XXXX-XXX-XXXX---XXXXX-XXXXXXXXXXXXXXXXXXXXXXXXXXXXXX-XXXX-------XXXX--XX-XXXXX--XXXX--XXXXXXXXXXXXXXXXXXXXX-XXXXXXXXXXXX--XXXX|XXX


