Genes: 1657,651,528,748,1630,1231,77,1095,647,1443,1251,528,1231,748
2,3,0,0,0,0,1,1,1,1,0,3,3,1
Fitness: 63.75
Constraints: 1.0
Age: 1
Level:
--------------------------------------------------------------------------------------------------------------------------------------------------------------------------------------------------------------------------------
--------------------------------------------------------------------------------------------------------------------------------------------------------------------------------------------------------------------------------
--------------------------------------------------------------------------------------------------------------------------------------------------------------------------------------------------------------------------------
---------------------------------------------------------------------------------------------------------------------------------------------------------S--------------------------------------------------SS------------------
-------------------------------------------------------------------------------------------------------------------------------------------------------------X------------------------------------------------------------------
-----------------------------------k-------------------------------------------------------------------------------------------------------------------------X------------------------------------------------------------------
----------------------S------------Q-----------------------------------------------------------------------------------------------R----------------------U--X------------------------------------------------------------------
-------------------------------------------------------------------------------------------------------------------------------------------------------------X------------------------------------------------------------------
-------------------------------------------------------------------------------------------------------------------------------------------------------------X------------S-----------------------------------------------------
---------------------------------------------------------o---------------------------------------------------------------------------------------------------X------------------------------------------------------------------
-------------------Q--S------------Q-------------------------------C--o------------C--L----------------------------o---------------------------------------U-X-----C-----------------------2---------C------U------o------------
-------------------------------------------------------------#-----------------------------------------------------------------------------------------------X------------------------------------------------------------------
-------------------------------------------------------------#-----S---------------S----------------------------------------------S-----------------------#--X-----S---#-----------S-----------------S-------t----T-------------
--k-----k-------------K-------------k---------------------g--#------kk--------------kk--------------k----k----------k--------------ok----S----------------#--X-------k-#-------------k-----------------k-k---t----T---#y--------
XXXXXXXXXXXXXXXXXXXXXXXXXXXXXXXXXX-XXXXXXXXXXXXXXXXXXX----XXXXXXXXX-XXXXXXXXXXXXXXX-XXXXXXXXXXXXXXXXXXXXXXXXXXXXXX-XXXXXXXXXXXXXXX-%XXXX------XXXXXXXXXXXXXXXXXXXXX-XXXXX----XXXXXX-XXXXXXXXXXXXXXXXX-XXXXXXXXXXXXXXXXXX------XX
XXXXXXXXXXXXXXXXXXXXXXXXXXXXXXXXXX-XXXXXXXXXXXXXXXXXXX----XXXXXXXXX-XXXXXXXXXXXXXXX-XXXXXXXXXXXXXXXXXXXXXXXXXXXXXX-XXXXXXXXXXXXXXX-|XXXX------XXXXXXXXXXXXXXXXXXXXX-XXXXX----XXXXXX-XXXXXXXXXXXXXXXXX-XXXXXXXXXXXXXXXXXX------XX


