Genes: 387,138,445,13,348,199,184,407,320,368,395,89,184,173
0,1,0,1,1,0,1,0,0,1,0,0,0,0
Fitness: 71.25
Constraints: 1.0
Age: 1
Level:
------------------------------------------------------------------------------------------------------------------------------------------------------------------------------------------------------------------------------------------------------------
------------------------------------------------------------------------------------------------------------------------------------------------------------------------S-----------------------------------------------------------------------------------
----------------------------k----------------------------S-----------------S-----------------------------------------------------------------------------------------------X--------------------------------------------------------------------------------
--------------------------S-#----------------------------S---------X-------S---------------------------------------------------------S------------SS-----------------------X---------------------------------------S----------------------------------------
-------------X--------------#--------------------X-------S---------X-------S---------------------------X-------------------------------------------S----------------------SX---------------------------------------S----------------------------------------
-------------X--------------#--------------------X-------S--------SX------S----------------------------X------S------------------------------------S-----------------------X---------------------------------------S----------------------------------------
--------Q----X--------------#--------------S-----X-----------------X------------------------------Q----X-------------------------------------------------------------------X---------------------------------------S------S---------------------------------
-------------X---------S--2-#--------------------X-----------------X-----------------------------------X--------------------------------------------------------------o----X--------------------------------------------------------------------------------
-------------X---------K----#--------------------X-----------------X-----------------------------------X-------------------------------------------------------------C--S--X--------------------------------------------------------------------------------
-------------X-------------T#--------------------X-------S--Q-U----X------SS---------------------------X------SQ-----------------------------------------?-----------------X------------------------------o-------------------------------------o-----------
--------?Q---X-------------T#-------------Q-U----X-------S---------X------KS----------------------?%---X------K------------------C--L--------------S--L--------------S-----X-----------------------------C--Q------S------SQ--------------------------------
-------------X----XXXXXXXXXXXXXXXX---------------X-------S---------X-------S---------------------------X--------------------------------S----------S------------------kk---X---------------------------------------S------K---------------------------------
-------------X----XXXXXXXXXXXXXXXX---------------X------#S---------X---------k-------------------------X--------kk---------------S-----------------S--------------XXX-XXXXXXXXXXXX-----------------------S---------S------------------------#---------------
---kk---g----X----XXXXXXXXXXXXXXXX-------#---g--kX----XXXXXXX-XXXXXXXX--XXXXXXXXXXXXXXXX----------g---kX----XXXXXX----XXXXXX------kk----------------gk---Sk-------XXX-XXXXXXXXXXXX-----##k-------g--------kk-------S--------kk--------------#---------------
XX-XXXXXXXXXXXXXXXXXXXXXXXXXXXXXXXXXXXXXXXXXXXXXXXXXXXXXXXXXX-XXXXXXXXXXXXXXXXXXXXXXXXXXXXXXXXXXXXX-XXXXXXXXXXXXXX----XXXXXXXXXXX-XXXXXX-XXXXXXXXXXXXXXXX-XXXXXXXXXXXXXXXXXXXXXXXXXXXXXXXXXX--XXXXXXXXXXX-XXXXXXXX-XXXXXXXXXXX----XXXXXXXXXXXXX-----XXXXXXXX
XX-XXXXXXXXXXXXXXXXXXXXXXXXXXXXXXXXXXXXXXXXXXXXXXXXXXXXXXXXXXXXXXXXXXXXXXXXXXXXXXXXXXXXXXXXXXXXXXXX-XXXXXXXXXXXXXXXXXXXXXXXXXXXXX-XXXXXX-XXXXXXXXXXXXXXXX-XXXXXXXXXXXXXXXXXXXXXXXXXXXXXXXXXX--XXXXXXXXXXX-XXXXXXXX-XXXXXXXXXXX----XXXXXXXXXXXXX-----XXXXXXXX


