Genes: 4,478,330,1001,404,330,122,478,122,1458,623,1221,930,1001
3,0,2,1,2,0,2,2,3,3,2,2,1,2
Fitness: 86.25
Constraints: 1.0
Age: 78
Level:
--------------------------------------------------------------------------------------------------------------------------------------------------------------------------------------------------------------------------------
--------------------------------------------------------------------------------------------------------------------------------------------------------------------------------------------------------------------------------
--------------------------------------------------------------------------------------------------------------------------------------------------------------------------------------------------------------------------------
-----------------------------------------------------------------------------------------------------------------------S--------------------------------------------------------------------------------------------------------
-------------------------------------------------------------------------------------------------------------------------------------------------------------------------------------------------------------X------------------
-------------------------------------------------------------------------------------------------------------------------------------------------------------------------------------------------------------X------------------
--------------------------------------------------------------------R---------------------------------------------------------------------------------------------------------------R------------------Q-----X------------------
-------------------------------------------------------------------#-----------------------------------------------------------------------------------------------------------------------------------------X------------------
-------------------------------------------------------------------#-----------------------------------------------------------------------------------------------------------------------------------------X------------------
-------------------------S-----------------------------------------#---------------------------------------------------------------------------------------------------------------------------------S-------X------------------
----U--------------------------------------------------------------#------------------------------------------------------------------------------SQ----------------------@----------------------------?-----X------------------
-------------------------------------------------------------------#------------------------------------------------------------------------------K-------------------------------K---U----------------------X------------------
----------------------------------#--------------------------------#--------------#--------------------------------------------------------------------------------------------------------------------------X------------------
-----kk------g------------g-------#-------------------------------##o-------------#------------------------------------#-----g--------------------------------------k-----g---------o---k---S%---------g-----X----------k-------
XXXXXXXXXXXXXXXXXXXXXXXXXXX---XXXXXXXXXXXXXXXXXXXXXXXXX-------XXXXXX%XXXXXXXXXXXXXXXXXXXXXXXXXXXXX----XXXXXXXXXXXX%--XXXXXXXXXXXXX-----XXXXXXXXXXXXXXXXXXXXXXXXXXX--XXXXXXXXXXXXXXXX%-%XXXXX--XXXX--XXXX-XXXXXXXXXXXXXXXXX----XX
XXXXXXXXXXXXXXXXXXXXXXXXXXX---XXXXXXXXXXXXXXXXXXXXXXXXX-------XXXXXX|XXXXXXXXXXXXXXXXXXXXXXXXXXXXX----XXXXXXXXXXXX---XXXXXXXXXXXXX-----XXXXXXXXXXXXXXXXXXXXXXXXXXX--XXXXXXXXXXXXXXXX|--XXXXX--XXXX--XXXX-XXXXXXXXXXXXXXXXX----XX


