Genes: 4,478,330,122,1001,1323,404,478,122,478,122,1001,1323,1622
0,0,0,3,2,0,0,2,3,3,3,2,3,2
Fitness: 70.0
Constraints: 1.0
Age: 1
Level:
--------------------------------------------------------------------------------------------------------------------------------------------------------------------------------------------------------------------------------
--------------------------------------------------------------------------------------------------------------------------------------------------------------------------------------------------------------------------------
--------------------------------------------------------------------------------------------------------------------------------------------------------------------------------------------------------------------------------
-----------------------------------------------------------------------------------------------------------------------S------------------------------------------------------------------------------------------SS------------
--------------------------------------------------------------------------------------------------------------------------------------------------------------------------------------------------------------------------------
--------------------------------------------------------------------------------------------------------------------------------------------------------------------------------------------------------------------------------
--------------------------------------------------------------------------------------------------------------------------------------------------------------------------------------------------------------------------------
--------------------------------------------------------------------------------------------------------------------------------------------------------S-----------------------------------------------------------------------
------------------------------------------------------------------------------------------------------------##------------------------------------------------------------------------------------------------------------------
-------------------------S----------------------------------------------------------------------------------##----------------------------------------Q-------------------------------------------------------------------------
--------U--------------------------------------------------------------------------------------------------!##----------------------------------------------------------------------------------------------------Q-------------
------------------------------------------------------------------------------------------------------------##------------------------------------------------------------------------------------------------------------------
----------------------------------#-------------------------------------------------------------------------##-----------------------------------------------------------------------------------------------------#------------
----------k---------------g-------#-------------------------------------k-----------------------------------##---------#-----g------------------------S---------------------------------k--------------------------#k-----------
XXXXXXXXXXXXXXXXXXXXXXXXXXX---XXXXXXXXXXXXXXXXXXXX-----XXXXXXXXXXXXXXXXXXX----XXXXXXXXXXXXXXXXXXXXXXXXXXXXXXXXXXXX%--XXXXXXXXXXXXX-----XXXXXXXXXXX-------XXXXXXXXX-----XXXXXXXXXXXXXXXXXXX----XXXXXXXXXXXXXXXXXXXXXXXXXXXXXXXXXX
XXXXXXXXXXXXXXXXXXXXXXXXXXX---XXXXXXXXXXXXXXXXXXXX-----XXXXXXXXXXXXXXXXXXX----XXXXXXXXXXXXXXXXXXXXXXXXXXXXXXXXXXXX---XXXXXXXXXXXXX-----XXXXXXXXXXX-------XXXXXXXXX-----XXXXXXXXXXXXXXXXXXX----XXXXXXXXXXXXXXXXXXXXXXXXXXXXXXXXXX


