Genes: 1323,4,478,330,1001,404,478,122,478,122,478,1323,1666,678
2,3,3,1,2,2,3,1,1,1,0,2,0,0
Fitness: 68.75
Constraints: 1.0
Age: 1
Level:
--------------------------------------------------------------------------------------------------------------------------------------------------------------------------------------------------------------------------------
--------------------------------------------------------------------------------------------------------------------------------------------------------------------------------------------------------------------------------
--------------------------------------------------------------------------------------------------------------------------------------------------------------------------------------------------------------------------------
--------------------------------------------------------------------------------------------------------------------------------------------------------------------------------------------------------------------------------
--------------------------------------------------------------------------------------------------------------------------------------------------------------------------------------------------------------------------------
--------------------------------------------------------------------------------------------------------------------------------------------------------------------------------------------------------------------------------
------------------------------------------------------------------------------------R-------------------------------------------------------------------------------------------------------------------------------------------
----------------------------------------S------------------------------------------#--------------------S-----------------------------------------------------------------------------------------------------------------------
-----------------------------------------------------------------------------------#--------------------------------------------------------------------------------------------------------------------------------------------
--------------------------------------Q--------------------------------------------#------------------Q------------------------------------------------------------------S------------------------------------------------------
--------------------U--------------------------------------------------------------#-------------------------------------------------------------------------------------------------------------------------------C------------
-----------------------------------------------------------------------------------#--------------------------------------------------------------------------------------------------------------------------------------------
--------------------------------------------------T--------------------------------#-------------------------------------------------------------------------------------------------------------------------------S------------
---------------------kk------g--------S-----------T---------------------k---------##o-----------------S-----------------------------k-#-----------------------------------g-----------------------k--k--------------------------
XXXXXXXXXXXXXXXXXXXXXXXXXXXXXXXXXX-------XXXXXXXXXXXXXXXXXXXXXXXXXXXXXXXXX----XXXXXX%XXXXXXXXXXXXX-------XXXXXXXXX-----XX-----XXXXXXXXX-------XXXX-----XX-----XXXXXXXXXXXXX---XXXXXXXXXXXXXXXXXXXXXXXXXXXXXXXXXXXX---------XXXXX
XXXXXXXXXXXXXXXXXXXXXXXXXXXXXXXXXX-------XXXXXXXXXXXXXXXXXXXXXXXXXXXXXXXXX----XXXXXX|XXXXXXXXXXXXX-------XXXXXXXXX-----XX-----XXXXXXXXX-------XXXX-----XX-----XXXXXXXXXXXXX---XXXXXXXXXXXXXXXXXXXXXXXXXXXXXXXXXXXX---------XXXXX


