Genes: 4,478,330,1602,1001,404,1323,404,1346,122,1323,807,737,415
2,0,0,2,0,3,3,0,0,2,2,2,0,1
Fitness: 83.75
Constraints: 1.0
Age: 12
Level:
--------------------------------------------------------------------------------------------------------------------------------------------------------------------------------------------------------------------------------
--------------------------------------------------------------------------------------------------------------------------------------------------------------------------------------------------------------------------------
--------------------------------------------------------------------------------------------------------------------------------------------------------------------------------------------------------------------------------
------------------------------------------------------------------------------------------------------------------------------------------------------------------------------------SS-S-S--------------------------------------
-----------------------------------------------------------------------------------------------------------------------------------------X-----------------------------------------------S---------------X-------------------X--
-----------------------------------------------------------------------------------------------------------------------------------------X-----------------------------------------------S---------------X-------------------X--
--------------------------------------------------------------------------------------------------------------------------------------S--X------------------------------------------Q----SS-------------QX-------------Q-----X--
-----------------------------------------------------------------------------------------------------------------------------------------X----------------------------------------------T----------------X------------S------X--
----------------------------------------------------------------------------------------------------------------------------##-----------X----------------------------------------------T----------------X-------------------X--
-------------------------S---------------------------------------------------------1----------------------------------------##----S------X-------------------------------------------o--T----------------X-------------------X--
---@------------------------------------------------------------------------------------T----------------------------------!##--------Q-UX------------------------------------------QS--XS---------C--S-?X-------------?--Q--X--
----------------------------------------------------------------------------------------T-----------------------------------##-----------X-----------------------------------------------S---------------X-------------------X--
----------------------------------#---------------So------------------------------#-----T-----------------------------------##-----------X----------------------------------------#------S---------S-----X-------------------X--
---g----------------------g-------#----------------%---------g--------------------#-----T-----------------------------------##-----------X----------------------------------------#---kkkS---g-------k--gX--------k----g-----X--
XXXXXXXXXXXXXXXXXXXXXXXXXXX---XXXXXXXXXXXXXXXXXXXX-|XXXXXXXXXXXXXXXXXX--------XXXXXXXXXXXXXXXXXXXXXXXXXXXXXXXXXXXXXXXXXXXXXXXXXXXXXXXXX-XXX---XXXX----XXXXXXXXXXXXXXXXXXXXXXXXXXXXXXXXXXXX--XXXXXXX-XX-XXXXXXXXXXXXXXX-XXXXXXXXX
XXXXXXXXXXXXXXXXXXXXXXXXXXX---XXXXXXXXXXXXXXXXXXXX-|XXXXXXXXXXXXXXXXXX--------XXXXXXXXXXXXXXXXXXXXXXXXXXXXXXXXXXXXXXXXXXXXXXXXXXXXXXXXX-XXX---XXXX----XXXXXXXXXXXXXXXXXXXXXXXXXXXXXXXXXXXX--XXXXXXX-XX-XXXXXXXXXXXXXXX-XXXXXXXXX


