Genes: 4,1323,330,843,404,478,478,404,122,400,478,516,859,1458
3,2,0,0,0,0,2,3,1,1,2,0,2,2
Fitness: 81.25
Constraints: 1.0
Age: 43
Level:
--------------------------------------------------------------------------------------------------------------------------------------------------------------------------------------------------------------------------------
--------------------------------------------------------------------------------------------------------------------------------------------------------------------------------------------------------------------------------
--------------------------------------------------------------------------------------------------------------------------------------------------------------------------------------------------------------------------------
-------------------------------------------------------------------------------------------------------S---------------------------------------------------------------S---------------------------------S----------------------
-------------------------------------------------------------------------------------------------------------------------------------------------------------------------------------------------------------X------------------
-------------------------------------------------------------------------------------------------------------------------------------------------------------------------------------------------------------X------------------
----------------------------------------------------------------------------------------------------------------------------------------------------------------------------------------------------------U--X------------------
-------------------------------------------------------------------------------------------------------------------------------------------------------------------------------------------------------------X------------------
----------------------------------------------------------------------------##------------------------------------------------------------------------------------------------------------S------------------X------------------
----------------------------------------------------------------------------##-----------S-------------------------1---------------------------------S-------------------------------------o-----------------X------------------
----U----------------------------------------------C--Q--------------------!##------------------------------------------T------------------------------S------------------------------L--------------------U-X------------Q-----
----------------------------------------------------------------------------##------------------------------------------T-----------------------------------------------------------------------------U------X------------------
----------------------------------#----------------S------------------------##------------------------------------#-----T------------------------------K---------------------------#---#------------------#--X------------------
-----kk------g--------------------#-----------------k#-------k--------------##------------g------------#-----g----#-----T-----------------------------#-----kk---------#-----g----##-k-#----------o-----kg#--X----------k---k---
XXXXXXXXXXXXXXXXXXXXXXXXXXXXXXXXXXXXXXXXXXXXXXXXXXX-XXXXX-XXXXXXXXXXXXXXXXXXXXXXXXXXXXXXXXX---XXXX%--XXXXXXXXXXXXXXXXXXXXXXXXXXXXX-----XX-----XXXXXXXXXXXX-XXXXXXX%--XXXXXXXXXXXXXXXXXXX------XXXX%XX-%XXXXXXXXXXXXXXXXXXXXXXXXX
XXXXXXXXXXXXXXXXXXXXXXXXXXXXXXXXXXXXXXXXXXXXXXXXXXX-XXXXX-XXXXXXXXXXXXXXXXXXXXXXXXXXXXXXXXX---XXXX---XXXXXXXXXXXXXXXXXXXXXXXXXXXXX-----XX-----XXXXXXXXXXXX-XXXXXXX---XXXXXXXXXXXXXXXXXXX------XXXX-XX--XXXXXXXXXXXXXXXXXXXXXXXXX


