Genes: 404,4,120,1103,1095,1545,623,1443,1522,245,404,104,1231,484
1,2,0,3,1,1,3,2,1,0,3,0,3,2
Fitness: 65.0
Constraints: 1.0
Age: 1
Level:
--------------------------------------------------------------------------------------------------------------------------------------------------------------------------------------------------------------------------------
--------------------------------------------------------------------------------------------------------------------------------------------------------------------------------------------------------------------------------
--------------------------------------------------------------------------------------------------------------------------------------------------------------------------------------------------------------------------------
------------------------------------------------------------------------------------------------------------------------------------------------------------------------------------------------------------SS------------------
-----------------------------------------X--------------------------------------------------------------------------------------------------------------------------------------------------------------------------------------
-----------------------------------------X--------------------------------------------------------------------------------------------------------------------------------------------------------------------------------------
---------------------------------------S-X--------------------------------------------------------------------------------------------------------------------------------------------------------------------------------------
-----------------------------------------X---------------------------------------------------------------------------S----------------------------------------------------------------------------------------------------------
-----------------------------------------X------------------------------------------------------------------------------T-------------------------------------------------------------------------------------------------------
-----------------------------------------X--------------------------------------------------------------------------?1--T-#----------------------------------------1------------------------------------------------------------
-------T-----------@----------------SSQ-UX---------S---------------o--------------------------------U-------------------#-#--------L---------------C--L-----------------T----------C-----------------C------U-------------------
-------T-----------------------------K---X--------------------------------------------------------------------------------#---------------------------------------------T-------------------------------------------------------
-------T---------------------------------X--------------------------------------------------------------------------------#------------------------S--------------#-----T----------S-----------------S-------t------------------
--k----T-----------g---------------------X----------K----k----------k---------------k----------------kk-------------S-----#---------k-#k------------k#------------#-----T-----------kk-----------------k-k---t---------------g--
XXXXXXXXXX----XXXXXXXXXXXXXXXXXXXXXXXXXXXXXXXXXXXXXXXXXXXXXXXXXXXX-XXXXXXXXXXXXXXX--XXXXX-----XXXXX-XXXXXXXXXXXXXX---XXXXXXXXXXXXXXXXXXX--XXXXXXXXX-XXXXXXXXXXXXXXXXXXXXXXXXXXXXXXX-XXXXXXX---XXXXXXX-XXXXXXXXXXXX---XXXXXXXXXXX
XXXXXXXXXX----XXXXXXXXXXXXXXXXXXXXXXXXXXXXXXXXXXXXXXXXXXXXXXXXXXXX-XXXXXXXXXXXXXXX--XXXXX-----XXXXX-XXXXXXXXXXXXXX---XXXXXXXXXXXXXXXXXXX--XXXXXXXXX-XXXXXXXXXXXXXXXXXXXXXXXXXXXXXXX-XXXXXXX---XXXXXXX-XXXXXXXXXXXX---XXXXXXXXXXX


